OOOOOOOOOOUOOOOOOOOOO
O  O       O .      O
O OOOO.OOOOO OOOOOO O
O      O   .        O
O OOOOOO OOO OOOOOOOO
O .    .  O  .    . O
OOOOOOOO OOO OOOOOO O
O        .   O      O
O OOOOOO OOOOO.OOOO O
O      . O       O  O
OOOOOOOOOOUOOOOOOOOOO